%%%%%%%%%%%%%%%%%%%%%%%%%%%%%%%%%
% P .....      ....      .....  %
%  ...  ...  ...  ...   ...  ...%
%  .    ...  ...  ...        ...%
%    ....    ...  ... G   ...   %
%  .    ...  ...  ...   ...     %
%  ...  ...  ...  ...   ...     %
%   .....      ....     ......o %
%%%%%%%%%%%%%%%%%%%%%%%%%%%%%%%%%
